15
10
1 2 2 2 2 2 2 1 2 2 2 2 2 2 1
2 6 2 6 5 2 6 2 6 2 5 6 2 6 2
2 6 2 6 5 2 6 7 6 2 5 6 2 6 2
2 6 2 6 5 2 6 2 6 2 5 6 2 6 2
2 2 2 2 4 4 4 4 4 4 4 2 2 2 2
7 2 6 6 3 3 6 6 6 3 3 6 6 2 7
2 2 2 2 2 3 6 2 6 3 2 2 2 2 2
2 6 2 6 8 3 2 2 2 3 8 6 2 6 2
2 6 2 6 8 2 6 6 6 2 8 6 2 6 2
2 2 2 2 2 2 6 0 6 2 2 2 2 2 2
10
10
0
0
0
0