15
10
1 8 8 3 3 5 5 5 8 8 8 5 5 5 1
3 3 3 3 8 8 8 5 6 8 8 6 5 5 3
3 3 8 3 5 5 8 5 6 8 8 6 5 5 3
3 3 8 3 5 5 5 5 6 5 5 6 3 3 3
8 8 8 5 5 5 6 6 6 6 6 8 8 8 8
8 8 8 5 5 8 8 8 8 8 8 8 8 8 8
2 2 4 4 4 4 4 3 3 3 3 3 8 8 8
8 8 8 8 8 8 8 8 8 8 5 5 8 8 8
2 3 3 3 3 3 6 6 6 2 5 5 8 8 8
1 3 3 3 8 2 6 0 6 2 5 5 8 8 8
10
10
0
0
0
0